NO images/horror/horror2.xpm
WE images/horror/horror2.xpm    
EA images/horror/horror3.xpm		
SO images/horror/horror1.xpm

F 5,5,5		
C 124,10,2

     1111111111111
111111000000000001
100000000110011001
100001100000000001
100001100110011001
101110000000000001
100111100000000111
110110000000000001
110011110001000111
111010000001000001
111011111101010111
10E0111111010101    
 11111111111111    
