F 235,242,249
	NO images/combo/lion.xpm
  WE		 images/combo/brick.xpm    
  		EA 	images/combo/blue_ice.xpm				

C          115,122,132

SO images/combo/white_ice.xpm

    111111111111
 11100000000001 
    1000000011111
   10011000000001  
 111000110011001111
11   0000000000001
100111100000000111
110110000000000001
110011110001000111
111010000001000001
111011111101010111
10E0111111010101    
 11111111111111    